5
*****
**..*
*.*.*
*...*
*****
2 4